billing_id,reservation_id,cleaning_fee,base_price,service_fee,taxes,total
0,8,72,993,70,72,1207
1,4,76,907,64,66,1113
2,7,95,666,47,49,857
3,1,88,502,36,37,663
4,0,92,511,36,38,677
5,5,60,609,43,45,757
6,6,76,200,15,15,306
7,4,62,743,53,54,912
8,9,81,907,64,66,1118
9,3,69,741,52,54,916
