billing_id,reservation_id,cleaning_fee,base_price,service_fee,taxes,total
1,1,72,696,49,51,868
2,2,75,359,26,27,487
3,3,54,280,20,21,375
4,4,61,895,63,65,1084
5,5,62,528,37,39,666
6,6,91,344,25,25,485
7,7,91,160,12,12,275
8,8,55,242,17,18,332
9,9,69,145,11,11,236
10,10,58,964,68,70,1160
